2 2 
1111111111111111
1111111000000000
1000000000020000
1000020002000000
1000000000000000
1000000000000000
1000000000000000
1002000000000000
1000000000000200
1000000002000000
1000200001111111
1000000000011111

1111111111111111
0000000000011111
0000020000001111
0000000002000111
0000000000000011
0002000000000001
0000000011100001
0000000011110001
0000000001111111
0000200000111111
1110000000000001
1110000000000001

1000000000000011
1000000000000011
1000020000000011
1001111111000011
1000111111000011
1000011111000000
1000000111000000
1100020000000000
1111000000000000
1111111110020000
1111111110000000
1111111111111111

1000000000000001
1000000000011001
1000000002011001
1000000000000001
1000020110000001
0000000111000011
0000200111002011
0011000110000011
0011111110000011
0000000000020111
0000000000001111
1111111111111111

