2 2 
1111111111111111
1111111000000000
1000000000000000
1000000000000000
1000000000000000
1000000000000000
1000000000000000
1000000000000000
1000000000000000
1000000000000000
1000000000000000
1000000000000000

1111111111111111
0000000000011111
0000000000001111
0000000000000111
0000000000000011
0000000000000001
0000000000000001
0000000000000001
0000000000000001
0000000000000001
0000000000000001
0000000000000001

1000000000000000
1000000000000000
1000000000000000
1000000000000000
1000000000000000
1000000000000000
1000000000000000
1000000000000000
1000000000000000
1000000000000000
1000000000000000
1111111111111111

0000000000000001
0000000000000001
0000000000000001
0000000000000001
0000000000000001
0000000000000011
0000000000000011
0000000000000011
0000000000000011
0000000000000111
0000000000001111
1111111111111111

